{
	"mapKey": "home",
	"terrain": [
		"^^^^^^^^^^T^^^^^^^^^^^^^^^^^^^^^^^^^",
		"^^^^^^^^^^^^^^TTT^^^^^^T^^^^^^^^T^^^",
		"################,,TT,,,TTTTT,,,,,T,,",
		"#.#............#,,,,,,,TT,,,,,,,,,,,",
		"#..............#,,T,,,,T,,,,,,T,,,,,",
		"#.##...........#,,,,,,,,,,,,,TTT,,,,",
		"#..............#,,T',,,,,,,,,TTT,,,,",
		"#.............##,,,,,,,,,,,,,,T,,,,,",
		"#..............+...,.,,,,,,,,,,,,,,,",
		"#######+########,,,,,,,,,,,,,,,',,,,",
		"#..#..#...#a.ss#,,,,,,,,,,,,,,,,,,,,",
		"#..#+##...#....#,,,,,,,,,,,,,,,,,,,.",
		"#.....+...+....#,,,,,,,,,,,,,,,,,,.~",
		"################,,,,''',,,,,,,,,,,.~",
		"^,T,,,,,,,,,,,,,,,,,,,,,.........~~~",
		"^.......................~~.~~~~~~~~~",
		"~~~~~~~~~~~~~~~~~~~~~~~~~~~~~~~~~~~~",
		"~~~~~~~~~~~~~~~~~~~~~~~~~~~~~~~~~~~~"
	],
	"blocks": {
		"111": {
			"tile": "brick"
		}
	},
	"items": {},
	"default": ".",
	"tiles": {
		".": "dirt",
		",": "grass",
		"^": "mountain",
		"~": "water",
		"'": "plant",
		"#": "brick",
		"+": "door",
		"T": "tree",
		"a": "apple",
		"s": "seeds"
	}
}
